"evt","SOA","Latency","Offset","evt_num","evt_fin","note"
"DI20",0,23349,0,20,NA,"not specified - std_aft/nov"
"DI11",500,23849,500,11,NA,"ignore"
"DIN1",500,24349,500,1,"stand",NA
"DIN1",500,24849,500,1,"stand",NA
"DI22",511,25360,511,22,"Cat_A_S?_Dog_V",NA
"DI11",500,25860,500,11,NA,"ignore"
"DIN1",500,26360,500,1,"stand",NA
"DI31",514,26874,514,31,"Dog_A_S?_Dog_V",NA
"DI11",500,27374,500,11,NA,"ignore"
"DIN1",500,27874,500,1,"stand",NA
"DI10",514,28388,514,10,NA,"not specified - std_aft/nov"
"DI11",500,28888,500,11,NA,"ignore"
"D202",254,29142,254,202,"Response",NA
"DIN1",246,29388,246,1,"stand",NA
"DIN1",500,29888,500,1,"stand",NA
"DI32",511,30399,511,32,"Dog_A_S?_Cat_V",NA
"DI11",500,30899,500,11,NA,"ignore"
"DIN1",500,31399,500,1,"stand",NA
"DI32",514,31913,514,32,"Dog_A_S?_Cat_V",NA
"DI11",499,32412,499,11,NA,"ignore"
"DIN1",501,32913,501,1,"stand",NA
"DI20",513,33426,513,20,NA,"not specified - std_aft/nov"
"DI11",500,33926,500,11,NA,"ignore"
"DIN1",500,34426,500,1,"stand",NA
"DIN1",500,34926,500,1,"stand",NA
"DI22",512,35438,512,22,"Cat_A_S?_Dog_V",NA
"DI11",500,35938,500,11,NA,"ignore"
"DIN1",500,36438,500,1,"stand",NA
"DI22",514,36952,514,22,"Cat_A_S?_Dog_V",NA
"DI11",500,37452,500,11,NA,"ignore"
"DIN1",500,37952,500,1,"stand",NA
"DIN1",500,38452,500,1,"stand",NA
"DI22",511,38963,511,22,"Cat_A_S?_Dog_V",NA
"DI11",500,39463,500,11,NA,"ignore"
"DIN1",500,39963,500,1,"stand",NA
"DIN1",500,40463,500,1,"stand",NA
"DI10",512,40975,512,10,NA,"not specified - std_aft/nov"
"DI11",500,41475,500,11,NA,"ignore"
"D202",131,41606,131,202,"Response",NA
"DIN1",369,41975,369,1,"stand",NA
"DIN1",500,42475,500,1,"stand",NA
"DI32",511,42986,511,32,"Dog_A_S?_Cat_V",NA
"DI11",500,43486,500,11,NA,"ignore"
"DIN1",500,43986,500,1,"stand",NA
"DI21",514,44500,514,21,"Cat_A_S?_Cat_V",NA
"DI11",500,45000,500,11,NA,"ignore"
"DIN1",500,45500,500,1,"stand",NA
"DI20",513,46013,513,20,NA,"not specified - std_aft/nov"
"DI11",500,46513,500,11,NA,"ignore"
"DIN1",500,47013,500,1,"stand",NA
"DIN1",500,47513,500,1,"stand",NA
"DI22",511,48024,511,22,"Cat_A_S?_Dog_V",NA
"DI11",500,48524,500,11,NA,"ignore"
"DIN1",500,49024,500,1,"stand",NA
"DIN1",500,49524,500,1,"stand",NA
"DI22",512,50036,512,22,"Cat_A_S?_Dog_V",NA
"DI11",500,50536,500,11,NA,"ignore"
"DIN1",500,51036,500,1,"stand",NA
"DI22",513,51549,513,22,"Cat_A_S?_Dog_V",NA
"DI11",500,52049,500,11,NA,"ignore"
"DIN1",500,52549,500,1,"stand",NA
"DIN1",500,53049,500,1,"stand",NA
"DI10",512,53561,512,10,NA,"not specified - std_aft/nov"
"DI11",501,54062,501,11,NA,"ignore"
"DIN1",500,54562,500,1,"stand",NA
"DIN1",500,55062,500,1,"stand",NA
"DI32",511,55573,511,32,"Dog_A_S?_Cat_V",NA
"DI11",500,56073,500,11,NA,"ignore"
"D202",221,56294,221,202,"Response",NA
"DIN1",279,56573,279,1,"stand",NA
"DIN1",500,57073,500,1,"stand",NA
"DI21",511,57584,511,21,"Cat_A_S?_Cat_V",NA
"DI11",500,58084,500,11,NA,"ignore"
"DIN1",500,58584,500,1,"stand",NA
"DI32",514,59098,514,32,"Dog_A_S?_Cat_V",NA
"DI11",500,59598,500,11,NA,"ignore"
"DIN1",500,60098,500,1,"stand",NA
"DIN1",500,60598,500,1,"stand",NA
"DI20",511,61109,511,20,NA,"not specified - std_aft/nov"
"DI11",500,61609,500,11,NA,"ignore"
"DIN1",500,62109,500,1,"stand",NA
"DIN1",500,62609,500,1,"stand",NA
"DI31",512,63121,512,31,"Dog_A_S?_Dog_V",NA
"DI11",500,63621,500,11,NA,"ignore"
"DIN1",499,64120,499,1,"stand",NA
"DIN1",500,64620,500,1,"stand",NA
"DI22",512,65132,512,22,"Cat_A_S?_Dog_V",NA
"DI11",500,65632,500,11,NA,"ignore"
"DIN1",500,66132,500,1,"stand",NA
"DI31",514,66646,514,31,"Dog_A_S?_Dog_V",NA
"DI11",500,67146,500,11,NA,"ignore"
"DIN1",500,67646,500,1,"stand",NA
"DIN1",500,68146,500,1,"stand",NA
"DI10",511,68657,511,10,NA,"not specified - std_aft/nov"
"DI11",500,69157,500,11,NA,"ignore"
"D202",457,69614,457,202,"Response",NA
"DIN1",43,69657,43,1,"stand",NA
"DIN1",500,70157,500,1,"stand",NA
"DI21",511,70668,511,21,"Cat_A_S?_Cat_V",NA
"DI11",500,71168,500,11,NA,"ignore"
"DIN1",500,71668,500,1,"stand",NA
"DI21",514,72182,514,21,"Cat_A_S?_Cat_V",NA
"DI11",500,72682,500,11,NA,"ignore"
"DIN1",500,73182,500,1,"stand",NA
"DIN1",500,73682,500,1,"stand",NA
"DI21",511,74193,511,21,"Cat_A_S?_Cat_V",NA
"DI11",500,74693,500,11,NA,"ignore"
"DIN1",500,75193,500,1,"stand",NA
"DIN1",500,75693,500,1,"stand",NA
"DI20",511,76204,511,20,NA,"not specified - std_aft/nov"
"DI11",501,76705,501,11,NA,"ignore"
"DIN1",500,77205,500,1,"stand",NA
"DIN1",500,77705,500,1,"stand",NA
"DI31",512,78217,512,31,"Dog_A_S?_Dog_V",NA
"DI11",500,78717,500,11,NA,"ignore"
"DIN1",500,79217,500,1,"stand",NA
"DI31",513,79730,513,31,"Dog_A_S?_Dog_V",NA
"DI11",500,80230,500,11,NA,"ignore"
"DIN1",500,80730,500,1,"stand",NA
"DI10",514,81244,514,10,NA,"not specified - std_aft/nov"
"DI11",500,81744,500,11,NA,"ignore"
"DIN1",500,82244,500,1,"stand",NA
"DIN1",500,82744,500,1,"stand",NA
"DI32",511,83255,511,32,"Dog_A_S?_Cat_V",NA
"DI11",500,83755,500,11,NA,"ignore"
"DIN1",500,84255,500,1,"stand",NA
"DI32",514,84769,514,32,"Dog_A_S?_Cat_V",NA
"DI11",500,85269,500,11,NA,"ignore"
"DIN1",500,85769,500,1,"stand",NA
"DI20",513,86282,513,20,NA,"not specified - std_aft/nov"
"DI11",500,86782,500,11,NA,"ignore"
"DIN1",500,87282,500,1,"stand",NA
"DIN1",500,87782,500,1,"stand",NA
"DI31",511,88293,511,31,"Dog_A_S?_Dog_V",NA
"DI11",500,88793,500,11,NA,"ignore"
"DIN1",500,89293,500,1,"stand",NA
"DI31",514,89807,514,31,"Dog_A_S?_Dog_V",NA
"DI11",500,90307,500,11,NA,"ignore"
"DIN1",500,90807,500,1,"stand",NA
"DI10",514,91321,514,10,NA,"not specified - std_aft/nov"
"DI11",500,91821,500,11,NA,"ignore"
"D202",185,92006,185,202,"Response",NA
"DIN1",315,92321,315,1,"stand",NA
"DIN1",500,92821,500,1,"stand",NA
"D202",89,92910,89,202,"Response",NA
"DI21",422,93332,422,21,"Cat_A_S?_Cat_V",NA
"DI11",500,93832,500,11,NA,"ignore"
"DIN1",500,94332,500,1,"stand",NA
"DI21",514,94846,514,21,"Cat_A_S?_Cat_V",NA
"DI11",500,95346,500,11,NA,"ignore"
"DIN1",500,95846,500,1,"stand",NA
"DIN1",500,96346,500,1,"stand",NA
"DI32",511,96857,511,32,"Dog_A_S?_Cat_V",NA
"DI11",500,97357,500,11,NA,"ignore"
"DIN1",500,97857,500,1,"stand",NA
"DIN1",500,98357,500,1,"stand",NA
"DI20",512,98869,512,20,NA,"not specified - std_aft/nov"
"DI11",500,99369,500,11,NA,"ignore"
"DIN1",500,99869,500,1,"stand",NA
"DIN1",500,100369,500,1,"stand",NA
"DI31",512,100881,512,31,"Dog_A_S?_Dog_V",NA
"DI11",500,101381,500,11,NA,"ignore"
"DIN1",500,101881,500,1,"stand",NA
"DI31",514,102395,514,31,"Dog_A_S?_Dog_V",NA
"DI11",500,102895,500,11,NA,"ignore"
"DIN1",500,103395,500,1,"stand",NA
"DI10",513,103908,513,10,NA,"not specified - std_aft/nov"
"D202",474,104382,474,202,"Response",NA
"DI11",26,104408,26,11,NA,"ignore"
"DIN1",500,104908,500,1,"stand",NA
"DIN1",500,105408,500,1,"stand",NA
"DI32",511,105919,511,32,"Dog_A_S?_Cat_V",NA
"DI11",500,106419,500,11,NA,"ignore"
"DIN1",500,106919,500,1,"stand",NA
"DIN1",500,107419,500,1,"stand",NA
"DI32",512,107931,512,32,"Dog_A_S?_Cat_V",NA
"DI11",500,108431,500,11,NA,"ignore"
"DIN1",500,108931,500,1,"stand",NA
"DIN1",500,109431,500,1,"stand",NA
"DI32",511,109942,511,32,"Dog_A_S?_Cat_V",NA
"DI11",500,110442,500,11,NA,"ignore"
"DIN1",500,110942,500,1,"stand",NA
"DI20",514,111456,514,20,NA,"not specified - std_aft/nov"
"DI11",500,111956,500,11,NA,"ignore"
"DIN1",500,112456,500,1,"stand",NA
"DIN1",500,112956,500,1,"stand",NA
"DI31",511,113467,511,31,"Dog_A_S?_Dog_V",NA
"DI11",500,113967,500,11,NA,"ignore"
"DIN1",500,114467,500,1,"stand",NA
"DIN1",500,114967,500,1,"stand",NA
"DI31",511,115478,511,31,"Dog_A_S?_Dog_V",NA
"DI11",500,115978,500,11,NA,"ignore"
"DIN1",500,116478,500,1,"stand",NA
"DI31",514,116992,514,31,"Dog_A_S?_Dog_V",NA
"DI11",500,117492,500,11,NA,"ignore"
"DIN1",500,117992,500,1,"stand",NA
"DIN1",500,118492,500,1,"stand",NA
"DI10",511,119003,511,10,NA,"not specified - std_aft/nov"
"D202",387,119390,387,202,"Response",NA
"DI11",113,119503,113,11,NA,"ignore"
"DIN1",500,120003,500,1,"stand",NA
"DIN1",500,120503,500,1,"stand",NA
"DI21",512,121015,512,21,"Cat_A_S?_Cat_V",NA
"DI11",500,121515,500,11,NA,"ignore"
"DIN1",500,122015,500,1,"stand",NA
"DI32",513,122528,513,32,"Dog_A_S?_Cat_V",NA
"DI11",500,123028,500,11,NA,"ignore"
"DIN1",500,123528,500,1,"stand",NA
"DI20",514,124042,514,20,NA,"not specified - std_aft/nov"
"DI11",500,124542,500,11,NA,"ignore"
"DIN1",500,125042,500,1,"stand",NA
"DIN1",500,125542,500,1,"stand",NA
"DI31",511,126053,511,31,"Dog_A_S?_Dog_V",NA
"DI11",500,126553,500,11,NA,"ignore"
"DIN1",500,127053,500,1,"stand",NA
"DIN1",500,127553,500,1,"stand",NA
"DI22",512,128065,512,22,"Cat_A_S?_Dog_V",NA
"DI11",500,128565,500,11,NA,"ignore"
"DIN1",500,129065,500,1,"stand",NA
"DI31",513,129578,513,31,"Dog_A_S?_Dog_V",NA
"DI11",500,130078,500,11,NA,"ignore"
"DIN1",500,130578,500,1,"stand",NA
"DIN1",500,131078,500,1,"stand",NA
"DI10",512,131590,512,10,NA,"not specified - std_aft/nov"
"D202",376,131966,376,202,"Response",NA
"DI11",125,132091,125,11,NA,"ignore"
"DIN1",500,132591,500,1,"stand",NA
"DIN1",500,133091,500,1,"stand",NA
"DI21",511,133602,511,21,"Cat_A_S?_Cat_V",NA
"DI11",500,134102,500,11,NA,"ignore"
"DIN1",500,134602,500,1,"stand",NA
"DI21",514,135116,514,21,"Cat_A_S?_Cat_V",NA
"DI11",500,135616,500,11,NA,"ignore"
"DIN1",500,136116,500,1,"stand",NA
"DIN1",500,136616,500,1,"stand",NA
"DI21",511,137127,511,21,"Cat_A_S?_Cat_V",NA
"DI11",500,137627,500,11,NA,"ignore"
"DIN1",500,138127,500,1,"stand",NA
"DIN1",500,138627,500,1,"stand",NA
"DI20",511,139138,511,20,NA,"not specified - std_aft/nov"
"DI11",500,139638,500,11,NA,"ignore"
"DIN1",500,140138,500,1,"stand",NA
"DIN1",500,140638,500,1,"stand",NA
"DI31",511,141149,511,31,"Dog_A_S?_Dog_V",NA
"DI11",500,141649,500,11,NA,"ignore"
"DIN1",500,142149,500,1,"stand",NA
"DI22",514,142663,514,22,"Cat_A_S?_Dog_V",NA
"DI11",500,143163,500,11,NA,"ignore"
"DIN1",500,143663,500,1,"stand",NA
"DI10",514,144177,514,10,NA,"not specified - std_aft/nov"
"D202",437,144614,437,202,"Response",NA
"DI11",63,144677,63,11,NA,"ignore"
"DIN1",500,145177,500,1,"stand",NA
"DIN1",500,145677,500,1,"stand",NA
"DI21",511,146188,511,21,"Cat_A_S?_Cat_V",NA
"DI11",500,146688,500,11,NA,"ignore"
"DIN1",500,147188,500,1,"stand",NA
"DI21",514,147702,514,21,"Cat_A_S?_Cat_V",NA
"DI11",500,148202,500,11,NA,"ignore"
"DIN1",500,148702,500,1,"stand",NA
"DIN1",500,149202,500,1,"stand",NA
"DI21",511,149713,511,21,"Cat_A_S?_Cat_V",NA
"DI11",500,150213,500,11,NA,"ignore"
"DIN1",500,150713,500,1,"stand",NA
"DIN1",500,151213,500,1,"stand",NA
"DI20",511,151724,511,20,NA,"not specified - std_aft/nov"
"DI11",500,152224,500,11,NA,"ignore"
"DIN1",500,152724,500,1,"stand",NA
"DIN1",500,153224,500,1,"stand",NA
"DI22",512,153736,512,22,"Cat_A_S?_Dog_V",NA
"DI11",500,154236,500,11,NA,"ignore"
"DIN1",500,154736,500,1,"stand",NA
"D202",182,154918,182,202,"Response",NA
"DI22",332,155250,332,22,"Cat_A_S?_Dog_V",NA
"DI11",500,155750,500,11,NA,"ignore"
"DIN1",499,156249,499,1,"stand",NA
"DI10",514,156763,514,10,NA,"not specified - std_aft/nov"
"DI11",500,157263,500,11,NA,"ignore"
"DIN1",500,157763,500,1,"stand",NA
"D202",35,157798,35,202,"Response",NA
"DIN1",465,158263,465,1,"stand",NA
"DI32",511,158774,511,32,"Dog_A_S?_Cat_V",NA
"DI11",500,159274,500,11,NA,"ignore"
"DIN1",500,159774,500,1,"stand",NA
"DI21",515,160289,515,21,"Cat_A_S?_Cat_V",NA
"DI11",500,160789,500,11,NA,"ignore"
"DIN1",500,161289,500,1,"stand",NA
"DI20",514,161803,514,20,NA,"not specified - std_aft/nov"
"DI11",500,162303,500,11,NA,"ignore"
"DIN1",500,162803,500,1,"stand",NA
"DIN1",500,163303,500,1,"stand",NA
"DI22",511,163814,511,22,"Cat_A_S?_Dog_V",NA
"DI11",500,164314,500,11,NA,"ignore"
"DIN1",500,164814,500,1,"stand",NA
"DI22",514,165328,514,22,"Cat_A_S?_Dog_V",NA
"DI11",500,165828,500,11,NA,"ignore"
"DIN1",500,166328,500,1,"stand",NA
"DI10",513,166841,513,10,NA,"not specified - std_aft/nov"
"DI11",500,167341,500,11,NA,"ignore"
"DIN1",500,167841,500,1,"stand",NA
"D202",77,167918,77,202,"Response",NA
"DIN1",423,168341,423,1,"stand",NA
"DI21",511,168852,511,21,"Cat_A_S?_Cat_V",NA
"DI11",500,169352,500,11,NA,"ignore"
"DIN1",500,169852,500,1,"stand",NA
"DIN1",500,170352,500,1,"stand",NA
"DI21",512,170864,512,21,"Cat_A_S?_Cat_V",NA
"DI11",500,171364,500,11,NA,"ignore"
"DIN1",500,171864,500,1,"stand",NA
"DIN1",500,172364,500,1,"stand",NA
"DI32",511,172875,511,32,"Dog_A_S?_Cat_V",NA
"DI11",500,173375,500,11,NA,"ignore"
"DIN1",500,173875,500,1,"stand",NA
"DI20",514,174389,514,20,NA,"not specified - std_aft/nov"
"DI11",500,174889,500,11,NA,"ignore"
"DIN1",500,175389,500,1,"stand",NA
"DIN1",500,175889,500,1,"stand",NA
"DI22",511,176400,511,22,"Cat_A_S?_Dog_V",NA
"DI11",500,176900,500,11,NA,"ignore"
"DIN1",500,177400,500,1,"stand",NA
"DIN1",500,177900,500,1,"stand",NA
"DI31",511,178411,511,31,"Dog_A_S?_Dog_V",NA
"DI11",500,178911,500,11,NA,"ignore"
"DIN1",500,179411,500,1,"stand",NA
"DI22",514,179925,514,22,"Cat_A_S?_Dog_V",NA
"DI11",500,180425,500,11,NA,"ignore"
"DIN1",500,180925,500,1,"stand",NA
"DIN1",500,181425,500,1,"stand",NA
"DI10",511,181936,511,10,NA,"not specified - std_aft/nov"
"DI11",500,182436,500,11,NA,"ignore"
"D202",426,182862,426,202,"Response",NA
"DIN1",74,182936,74,1,"stand",NA
"DIN1",500,183436,500,1,"stand",NA
"DI21",512,183948,512,21,"Cat_A_S?_Cat_V",NA
"DI11",500,184448,500,11,NA,"ignore"
"DIN1",500,184948,500,1,"stand",NA
"DI21",513,185461,513,21,"Cat_A_S?_Cat_V",NA
"DI11",500,185961,500,11,NA,"ignore"
"DIN1",500,186461,500,1,"stand",NA
"DI20",514,186975,514,20,NA,"not specified - std_aft/nov"
"DI11",500,187475,500,11,NA,"ignore"
"DIN1",500,187975,500,1,"stand",NA
"DIN1",500,188475,500,1,"stand",NA
"DI22",511,188986,511,22,"Cat_A_S?_Dog_V",NA
"DI11",500,189486,500,11,NA,"ignore"
"DIN1",500,189986,500,1,"stand",NA
"DIN1",500,190486,500,1,"stand",NA
"DI22",512,190998,512,22,"Cat_A_S?_Dog_V",NA
"DI11",500,191498,500,11,NA,"ignore"
"DIN1",501,191999,501,1,"stand",NA
"DI31",513,192512,513,31,"Dog_A_S?_Dog_V",NA
"DI11",500,193012,500,11,NA,"ignore"
"DIN1",500,193512,500,1,"stand",NA
"DIN1",500,194012,500,1,"stand",NA
"DI10",512,194524,512,10,NA,"not specified - std_aft/nov"
"DI11",500,195024,500,11,NA,"ignore"
"D202",206,195230,206,202,"Response",NA
"DIN1",294,195524,294,1,"stand",NA
"DIN1",500,196024,500,1,"stand",NA
"DI32",511,196535,511,32,"Dog_A_S?_Cat_V",NA
"DI11",500,197035,500,11,NA,"ignore"
"DIN1",500,197535,500,1,"stand",NA
"DI32",514,198049,514,32,"Dog_A_S?_Cat_V",NA
"DI11",500,198549,500,11,NA,"ignore"
"DIN1",500,199049,500,1,"stand",NA
"DI20",513,199562,513,20,NA,"not specified - std_aft/nov"
"DI11",500,200062,500,11,NA,"ignore"
"DIN1",500,200562,500,1,"stand",NA
"DIN1",500,201062,500,1,"stand",NA
"DI22",511,201573,511,22,"Cat_A_S?_Dog_V",NA
"DI11",500,202073,500,11,NA,"ignore"
"DIN1",500,202573,500,1,"stand",NA
"DI31",514,203087,514,31,"Dog_A_S?_Dog_V",NA
"DI11",500,203587,500,11,NA,"ignore"
"DIN1",500,204087,500,1,"stand",NA
"DI10",514,204601,514,10,NA,"not specified - std_aft/nov"
"D202",469,205070,469,202,"Response",NA
"DI11",30,205100,30,11,NA,"ignore"
"DIN1",500,205600,500,1,"stand",NA
"DIN1",500,206100,500,1,"stand",NA
"DI21",512,206612,512,21,"Cat_A_S?_Cat_V",NA
"DI11",500,207112,500,11,NA,"ignore"
"DIN1",500,207612,500,1,"stand",NA
"DIN1",500,208112,500,1,"stand",NA
"DI32",511,208623,511,32,"Dog_A_S?_Cat_V",NA
"DI11",500,209123,500,11,NA,"ignore"
"DIN1",500,209623,500,1,"stand",NA
"DIN1",500,210123,500,1,"stand",NA
"DI32",512,210635,512,32,"Dog_A_S?_Cat_V",NA
"DI11",500,211135,500,11,NA,"ignore"
"DIN1",500,211635,500,1,"stand",NA
"DI20",514,212149,514,20,NA,"not specified - std_aft/nov"
"DI11",500,212649,500,11,NA,"ignore"
"DIN1",500,213149,500,1,"stand",NA
"DIN1",500,213649,500,1,"stand",NA
"DI31",511,214160,511,31,"Dog_A_S?_Dog_V",NA
"DI11",500,214660,500,11,NA,"ignore"
"DIN1",500,215160,500,1,"stand",NA
"DIN1",500,215660,500,1,"stand",NA
"DI22",512,216172,512,22,"Cat_A_S?_Dog_V",NA
"DI11",500,216672,500,11,NA,"ignore"
"DIN1",500,217172,500,1,"stand",NA
"DI22",513,217685,513,22,"Cat_A_S?_Dog_V",NA
"DI11",500,218185,500,11,NA,"ignore"
"DIN1",500,218685,500,1,"stand",NA
"DIN1",500,219185,500,1,"stand",NA
"DI10",512,219697,512,10,NA,"not specified - std_aft/nov"
"DI11",500,220197,500,11,NA,"ignore"
"DIN1",500,220697,500,1,"stand",NA
"DIN1",500,221197,500,1,"stand",NA
"DI21",511,221708,511,21,"Cat_A_S?_Cat_V",NA
"DI11",500,222208,500,11,NA,"ignore"
"DIN1",500,222708,500,1,"stand",NA
"DI32",514,223222,514,32,"Dog_A_S?_Cat_V",NA
"DI11",500,223722,500,11,NA,"ignore"
"DIN1",500,224222,500,1,"stand",NA
"DI20",513,224735,513,20,NA,"not specified - std_aft/nov"
"DI11",500,225235,500,11,NA,"ignore"
"DIN1",500,225735,500,1,"stand",NA
"DIN1",500,226235,500,1,"stand",NA
"DI31",511,226746,511,31,"Dog_A_S?_Dog_V",NA
"DI11",500,227246,500,11,NA,"ignore"
"DIN1",500,227746,500,1,"stand",NA
"DI31",514,228260,514,31,"Dog_A_S?_Dog_V",NA
"DI11",500,228760,500,11,NA,"ignore"
"DIN1",500,229260,500,1,"stand",NA
"DI10",514,229774,514,10,NA,"not specified - std_aft/nov"
"DI11",500,230274,500,11,NA,"ignore"
"DIN1",500,230774,500,1,"stand",NA
"DIN1",500,231274,500,1,"stand",NA
"DI32",511,231785,511,32,"Dog_A_S?_Cat_V",NA
"DI11",500,232285,500,11,NA,"ignore"
"DIN1",500,232785,500,1,"stand",NA
"DIN1",500,233285,500,1,"stand",NA
"DI21",511,233796,511,21,"Cat_A_S?_Cat_V",NA
"DI11",500,234296,500,11,NA,"ignore"
"D202",141,234437,141,202,"Response",NA
"DIN1",359,234796,359,1,"stand",NA
"DIN1",500,235296,500,1,"stand",NA
"DI32",513,235809,513,32,"Dog_A_S?_Cat_V",NA
"DI11",500,236309,500,11,NA,"ignore"
"DIN1",500,236809,500,1,"stand",NA
"DI20",513,237322,513,20,NA,"not specified - std_aft/nov"
"DI11",500,237822,500,11,NA,"ignore"
"DIN1",500,238322,500,1,"stand",NA
"DIN1",500,238822,500,1,"stand",NA
"DI31",512,239334,512,31,"Dog_A_S?_Dog_V",NA
"DI11",500,239834,500,11,NA,"ignore"
"DIN1",500,240334,500,1,"stand",NA
"DIN1",500,240834,500,1,"stand",NA
"DI31",511,241345,511,31,"Dog_A_S?_Dog_V",NA
"DI11",500,241845,500,11,NA,"ignore"
"DIN1",500,242345,500,1,"stand",NA
"DIN1",500,242845,500,1,"stand",NA
"DI22",511,243356,511,22,"Cat_A_S?_Dog_V",NA
"DI11",500,243856,500,11,NA,"ignore"
"DIN1",500,244356,500,1,"stand",NA
"DI10",514,244870,514,10,NA,"not specified - std_aft/nov"
"DI11",500,245370,500,11,NA,"ignore"
"DIN1",500,245870,500,1,"stand",NA
"DIN1",500,246370,500,1,"stand",NA
"DI32",511,246881,511,32,"Dog_A_S?_Cat_V",NA
"DI11",500,247381,500,11,NA,"ignore"
"DIN1",500,247881,500,1,"stand",NA
"DI32",514,248395,514,32,"Dog_A_S?_Cat_V",NA
"DI11",500,248895,500,11,NA,"ignore"
"DIN1",500,249395,500,1,"stand",NA
"DI20",513,249908,513,20,NA,"not specified - std_aft/nov"
"DI11",500,250408,500,11,NA,"ignore"
"DIN1",500,250908,500,1,"stand",NA
"DIN1",500,251408,500,1,"stand",NA
"DI22",512,251920,512,22,"Cat_A_S?_Dog_V",NA
"DI11",500,252420,500,11,NA,"ignore"
"DIN1",500,252920,500,1,"stand",NA
"DI22",514,253434,514,22,"Cat_A_S?_Dog_V",NA
"DI11",500,253934,500,11,NA,"ignore"
"DIN1",500,254434,500,1,"stand",NA
"DI10",514,254948,514,10,NA,"not specified - std_aft/nov"
"DI11",500,255448,500,11,NA,"ignore"
"D202",261,255709,261,202,"Response",NA
"DIN1",239,255948,239,1,"stand",NA
"DIN1",499,256447,499,1,"stand",NA
"DI21",512,256959,512,21,"Cat_A_S?_Cat_V",NA
"DI11",500,257459,500,11,NA,"ignore"
"DIN1",500,257959,500,1,"stand",NA
"DI21",514,258473,514,21,"Cat_A_S?_Cat_V",NA
"DI11",500,258973,500,11,NA,"ignore"
"DIN1",500,259473,500,1,"stand",NA
"DI20",513,259986,513,20,NA,"not specified - std_aft/nov"
"DI11",500,260486,500,11,NA,"ignore"
"DIN1",500,260986,500,1,"stand",NA
"DIN1",500,261486,500,1,"stand",NA
"DI31",511,261997,511,31,"Dog_A_S?_Dog_V",NA
"DI11",500,262497,500,11,NA,"ignore"
"DIN1",500,262997,500,1,"stand",NA
"DIN1",500,263497,500,1,"stand",NA
"DI22",512,264009,512,22,"Cat_A_S?_Dog_V",NA
"DI11",500,264509,500,11,NA,"ignore"
"DIN1",500,265009,500,1,"stand",NA
"DIN1",500,265509,500,1,"stand",NA
"DI31",511,266020,511,31,"Dog_A_S?_Dog_V",NA
"DI11",500,266520,500,11,NA,"ignore"
"D202",205,266725,205,202,"Response",NA
"DIN1",295,267020,295,1,"stand",NA
"DI10",514,267534,514,10,NA,"not specified - std_aft/nov"
"DI11",500,268034,500,11,NA,"ignore"
"DIN1",500,268534,500,1,"stand",NA
"DIN1",500,269034,500,1,"stand",NA
"DI32",511,269545,511,32,"Dog_A_S?_Cat_V",NA
"DI11",500,270045,500,11,NA,"ignore"
"DIN1",500,270545,500,1,"stand",NA
"DI32",514,271059,514,32,"Dog_A_S?_Cat_V",NA
"DI11",500,271559,500,11,NA,"ignore"
"DIN1",500,272059,500,1,"stand",NA
"DIN1",500,272559,500,1,"stand",NA
"DI21",511,273070,511,21,"Cat_A_S?_Cat_V",NA
"DI11",500,273570,500,11,NA,"ignore"
"DIN1",500,274070,500,1,"stand",NA
"DIN1",500,274570,500,1,"stand",NA
